{
  "tiles" : [ [1, 1, 1, 0, 1, 0, 1, 1, 1 ],
              [1, 1, 1, 0, 1, 0, 1, 1, 1 ],
              [1, 1, 1, 1, 1, 1, 1, 1, 1 ],
              [0, 0, 0, 1, 1, 1, 0, 0, 0 ],
              [1, 1, 1, 1, 1, 1, 1, 1, 1 ],
              [0, 0, 0, 1, 1, 1, 0, 0, 0 ],
              [1, 1, 1, 1, 1, 1, 1, 1, 1 ],
              [1, 1, 1, 0, 1, 0, 1, 1, 1 ],
              [1, 1, 1, 0, 1, 0, 1, 1, 1 ] ],

  "definedType": 0,
  "predefined" : false,
  "targetScore" : 1000,
  "moves" : 15,
}
