{
  "tiles" : [ [0, 1, 1, 0, 0, 1, 1, 0 ],
              [1, 1, 1, 1, 1, 1, 1, 1 ],
              [1, 1, 1, 1, 1, 1, 1, 1 ],
              [1, 1, 1, 1, 1, 1, 1, 1 ],
              [0, 0, 1, 1, 1, 1, 0, 0 ],
              [1, 1, 1, 1, 1, 1, 1, 1 ],
              [1, 1, 1, 1, 1, 1, 1, 1 ],
              [1, 1, 1, 1, 1, 1, 1, 1 ],
              [0, 1, 1, 0, 0, 1, 1, 0 ] ],

  "definedType": 0,
  "predefined" : false,
  "targetScore" : 1000,
  "moves" : 15
}
